xxxxxxxxx
xxxxxxxxx
xx_____xx
xx_____xx
xx__o__xx
xx_____xx
xx__g__xx
xxxxxxxxx
xxxxxxxxx
